1;5;1;5;3;2;5;3;3;5;3;0;;;;;;
1;5;1;10;4;2;10;4;3;10;4;5;2;3;0;;;
1;5;1;20;6;2;20;6;3;20;6;5;5;3;6;6;3;0
1;5;1;30;8;2;30;8;3;30;8;5;8;3;6;10;3;0
1;5;1;40;10;2;40;10;3;40;10;5;10;3;6;15;3;0
