1;5;1;4;3;3;1;3;0
2;5;1;8;3;3;5;3;0
3;5;1;15;3;3;7;3;0
4;5;1;24;3;3;10;3;0
5;5;1;30;3;3;15;3;0
6;5;1;35;2;3;18;3;0
