1;5;2;5;3;0;;;;;;
2;5;1;7;3;2;1;3;0;;;
3;5;1;14;3;2;2;3;0;;;
4;5;1;17;3;2;5;3;3;4;3;0
5;5;1;20;3;2;4;3;3;10;3;0
6;5;1;20;3;2;8;3;3;15;3;0
